...#.......#
#......####
#.#..###..#
##........#
#....#....#
###..###..#
.#.#..#...#
.##.##.#.##
.#........#
.#..@.#...#
.......##..
#########